XXXXXXXXXXXXXXX
XS     XXXXXXXX
XXXXXX XXXXXXXX
XXXXXX XXXXXXXX
XXXXXX        X
XXXXXXXXXXXXX X
XXXXXXXXXXXXX X
XE            X
XXXXXXXXXXXXXXX
